##########
#       E#
#        #
#        #
#        #
##########