##########
#   #   E#
#   #    #
#   ######
#S       #
##########