##########
#       S#
#        #
#        #
#E       #
##########