##########
#       E#
#        #
#        #
#S       #
##########