##########
#       E#
# # # # ##
## # # # #
#S       #
##########