##########
#        #
#        #
#        #
#S       #
##########