##########
#   #   S#
# # #    #
# # # ####
#E#      #
##########