##########
#   #   E#
# # #    #
# # # ####
#S#      #
##########